ori_dbid,display_name,related_events,related_organizations,related_people,related_places,related_recognitions,related_resources,related_works,related_total_count
4da194fcb538b73d9300099d,"""Bernice Agar""",2,0,3,6,0,7,2,20
4da194feb538b73d93000a99,"""Clara Southern""",11,0,19,8,3,9,0,50
4da194feb538b73d93000ad6,"""Ruth Drummond Ainsworth""",2,0,8,15,0,6,1,32
4da19501b538b73d93000cdf,"""Ailsa Allan""",6,0,5,8,0,11,4,34
4da19502b538b73d93000d04,"""Harold Desbrowe Annear""",0,0,1,4,0,3,0,8
4da19504b538b73d93000e0d,"""Joyce L. McC Allen""",16,0,11,5,1,10,11,54
4da19504b538b73d93000e56,"""Mary Cecil Allen""",3,0,7,15,0,7,0,32
4da19506b538b73d93000f31,"""Sophie Steffanoni""",4,0,6,2,1,12,4,29
4da19506b538b73d93000f89,"""Curzona Frances Louise Allport""",12,0,8,8,0,9,13,50
4da1950cb538b73d930010c2,"""Edith Annie Mary Alsop""",2,0,9,9,2,16,4,42
4da1950fb538b73d93001328,"""Ethel Anderson""",1,0,9,6,0,22,0,38
4da19512b538b73d93001531,"""Brook Andrew""",19,0,7,5,8,12,8,59
4da19530b538b73d9300249f,"""Alice Marion Ellen Bale""",17,0,8,6,1,11,6,49
4da19531b538b73d930025ac,"""Bronwyn Bancroft""",33,0,14,6,20,10,4,87
4da19533b538b73d930026ed,"""Ralph Balson""",4,0,5,1,0,1,1,12
4da1953bb538b73d93002a4e,"""Ethel Barringer""",3,0,12,9,4,8,0,36
4da19547b538b73d93002e7e,"""Margaret Checkley Beatty""",2,0,4,6,0,2,1,15
4da1954db538b73d9300309f,"""Ruth Sutherland""",1,0,4,0,0,1,0,6
4da19552b538b73d93003253,"""Jean Mary Bellette""",18,0,14,10,2,8,3,55
4da19556b538b73d93003473,"""Portia Mary Bennett""",22,0,5,8,3,1,7,46
4da1955bb538b73d9300368d,"""Yosl Bergner""",6,0,6,9,0,4,2,27
4da1955bb538b73d93003704,"""Eileen Constance Matilda Berndt""",2,0,3,6,0,1,1,13
4da19562b538b73d930038f7,"""Ada Petyarre Bird""",5,0,8,3,0,5,3,24
4da19563b538b73d93003986,"""Karna Marie Birmingham""",5,0,8,4,0,18,6,41
4da19565b538b73d93003a10,"""Dorrit Black""",13,0,20,12,0,12,5,62
4da19566b538b73d93003a9d,"""Vera Blackburn""",8,0,16,8,0,8,1,41
4da19567b538b73d93003acb,"""Charles Blackman""",9,0,19,15,3,3,4,53
4da1956ab538b73d93003bcd,"""Antonia Blaxland""",0,0,5,4,0,7,3,19
4da19570b538b73d93003dbb,"""William Rose Bock""",0,0,3,4,0,1,0,8
4da19571b538b73d93003ddf,"""Edwin Bode""",0,0,2,9,0,4,10,25
4da19574b538b73d93003efa,"""Nancy Wilmot Borlase""",12,0,7,6,4,8,2,39
4da19577b538b73d93003fb4,"""Euphemia Bostock""",6,0,8,6,3,5,2,30
4da1957bb538b73d9300414b,"""Stella Bowen""",9,0,2,10,0,16,4,41
4da1957eb538b73d930042a8,"""Arthur Boyd""",28,0,25,10,1,12,10,86
4da19583b538b73d93004476,"""John Brack""",12,0,9,4,1,0,4,30
4da19587b538b73d930045bb,"""Barbara Nancy Brash""",2,0,17,5,0,3,5,32
4da1958ab538b73d93004719,"""Anne Brennan""",2,0,3,0,0,0,1,6
4da19595b538b73d93004b57,"""Jean Broome-Norton""",4,0,8,4,0,8,3,27
4da19598b538b73d93004bfb,"""Frederick A. Brown""",2,0,4,2,0,5,1,14
4da1959ab538b73d93004cb5,"""Mike Brown""",14,0,5,5,0,2,0,26
4da195a5b538b73d93005072,"""Frances Phoenix""",12,0,1,0,0,1,1,15
4da195abb538b73d93005268,"""Tom Roberts""",8,0,51,13,1,9,8,90
4da195abb538b73d930052a7,"""E. Phillips Fox""",1,0,23,7,0,3,5,39
4da195bdb538b73d93005882,"""Mona Byrnes""",5,0,3,3,0,7,0,18
4da195c1b538b73d9300597e,"""Nutter Buzacott""",14,0,19,14,1,24,4,76
4da195c6b538b73d93005ad4,"""Betty Grace""",1,0,4,2,1,2,1,11
4da195d9b538b73d93005fc3,"""James Montgomery Cant""",1,0,6,1,0,4,5,17
4da195f4b538b73d9300673d,"""Enid de Chair""",0,0,6,1,0,20,0,27
4da195fab538b73d930068ae,"""Dora Cecil Chapman""",7,0,11,11,2,7,3,41
4da19603b538b73d93006af3,"""Lilian Chauvel""",9,0,3,5,0,9,73,99
4da19604b538b73d93006bb9,"""Chelmsford""",2,0,1,1,0,1,10,15
4da19604b538b73d93006bd7,"""G Rodney Cherry""",2,0,5,3,0,0,0,10
4da19605b538b73d93006bf0,"""George Cherry""",1,0,6,9,0,12,6,34
4da1960db538b73d93006dcf,"""Margaret Cilento""",9,0,7,17,2,11,3,49
4da19619b538b73d930070fb,"""Marian Clarke""",1,0,1,2,0,2,7,13
4da19620b538b73d93007360,"""Jacqueline Clayton""",2,0,7,1,0,3,2,15
4da1962fb538b73d93007648,"""George Coates""",0,0,16,10,0,5,2,33
4da19634b538b73d93007740,"""Myra Cocks""",4,0,8,15,0,7,9,43
4da19637b538b73d930077e8,"""Alfred R. Coffey""",11,0,12,12,8,23,14,80
4da19648b538b73d93007c6a,"""Albert Collins""",0,0,7,3,0,4,2,16
4da1964db538b73d93007d07,"""Amalie Sara Colquhoun""",4,0,9,6,0,11,6,36
4da19661b538b73d9300806c,"""Muriel Warren Cornish""",6,0,3,3,0,6,1,19
4da19666b538b73d930081a0,"""Noel Counihan""",16,0,26,4,0,12,9,67
4da19669b538b73d93008259,"""Theodora Esther Cowan""",4,0,3,8,1,23,7,46
4da19672b538b73d930083ab,"""Sybil Mary Frances Craig""",17,0,9,7,0,12,0,45
4da19674b538b73d9300840d,"""Olive Crane""",4,0,9,8,0,14,0,35
4da19677b538b73d93008498,"""Helen Maxwell Crear""",0,0,6,2,0,0,4,12
4da19682b538b73d930086c5,"""Grace Crowley""",16,0,23,10,0,9,4,62
4da19683b538b73d9300871d,"""Janet Cumming""",2,0,1,3,0,4,4,14
4da1968eb538b73d93008902,"""Robert Emerson Curtis""",5,0,7,17,0,19,3,51
4da19690b538b73d9300894e,"""Aline M. Cusack""",5,0,7,2,0,4,0,18
4da19690b538b73d93008981,"""Edith E. Cusack""",10,0,6,10,0,26,15,67
4da19694b538b73d93008a6d,"""Lyndon Dadswell""",3,0,15,0,0,3,1,22
4da1969ab538b73d93008b3a,"""Roy Frederick Leslie Dalgarno""",11,0,11,20,1,10,8,61
4da1969db538b73d93008c18,"""George Henry Dancey""",0,0,6,3,0,7,3,19
4da1969fb538b73d93008c40,"""Alice Danciger""",10,0,15,7,0,8,2,42
4da196a0b538b73d93008c76,"""Annie Garvin Dangar""",4,0,3,15,0,15,0,37
4da196afb538b73d93008d76,"""Bill Spencer""",5,0,5,4,4,3,1,22
4da196b3b538b73d93008e6e,"""Bessie Davidson""",14,0,4,15,1,6,4,44
4da196c5b538b73d930091d1,"""Isobel Delroy""",1,0,1,2,0,2,2,8
4da196ccb538b73d930092b9,"""Frances Alexander Mabel Letitia Derham""",4,0,7,9,1,12,0,33
4da196deb538b73d930095cd,"""William Dobell""",5,0,35,10,3,7,6,66
4da196ebb538b73d930099a1,"""Russell Drysdale""",13,0,12,21,0,6,4,56
4da196f0b538b73d93009b14,"""Douglas Dundas""",2,0,13,0,0,1,3,19
4da196f8b538b73d93009d34,"""Ella Maggie Dwyer""",2,0,7,7,0,5,1,22
4da196f8b538b73d93009d44,"""Moya Dyring""",5,0,7,3,0,1,2,18
4da1971db538b73d9300a21f,"""Mary Edwards""",16,0,9,7,1,22,2,57
4da1971db538b73d9300a258,"""Mary Cooper Edwards""",4,0,2,4,0,2,1,13
4da19721b538b73d9300a2a8,"""Bernice E. Edwell""",6,0,22,11,1,11,6,57
4da19732b538b73d9300a600,"""Mary Alice Evatt""",1,0,21,16,2,9,17,66
4da1973cb538b73d9300a7b8,"""Helen Marguerite Farmer""",3,0,9,9,1,2,1,25
4da19765b538b73d9300ac88,"""Ann Judith Fletcher""",1,0,7,7,0,14,1,30
4da19766b538b73d9300aca2,"""Marjorie Fletcher""",2,0,5,5,0,3,6,21
4da1976db538b73d9300ace8,"""James Flett""",0,0,8,3,1,7,2,21
4da19771b538b73d9300ae20,"""Fiona Foley""",17,0,17,8,10,10,11,73
4da1977cb538b73d9300b05e,"""Alexander Fox""",0,0,8,9,0,15,1,33
4da1978db538b73d9300b2fe,"""Donald Friend""",5,0,19,4,0,15,15,58
4da19793b538b73d9300b437,"""Ella J. Osborn Fry""",13,0,6,8,3,4,6,40
4da197a0b538b73d9300b6e9,"""John Gardner""",2,0,5,5,0,6,0,18
4da197a7b538b73d9300b85f,"""Elizabeth Gibson""",15,0,4,8,1,10,2,40
4da197abb538b73d9300b8f5,"""Portia Geach""",9,0,4,6,2,14,8,43
4da197afb538b73d9300b9e4,"""May George""",12,0,2,4,0,7,5,30
4da197b2b538b73d9300ba9d,"""Gladys Noeline Gibbons""",6,0,1,3,0,10,1,21
4da197d5b538b73d9300c0bf,"""Nancy Goldfinch""",7,0,12,9,2,3,0,33
4da197e3b538b73d9300c364,"""Joan Gough""",2,0,6,5,3,3,1,20
4da197ecb538b73d9300c538,"""Gwendolyn Grant""",4,0,7,4,0,5,4,24
4da197f5b538b73d9300c5fa,"""Annie Louisa Green""",0,0,4,1,0,2,1,8
4da197f7b538b73d9300c629,"""John Green""",0,0,7,2,0,1,0,10
4da197f9b538b73d9300c68e,"""Anne Alison Greene""",5,0,5,10,1,10,2,33
4da197f9b538b73d9300c6a2,"""Nancy Greene""",1,0,4,6,1,3,0,15
4da197ffb538b73d9300c7f1,"""Ina Gregory""",4,0,6,3,1,8,1,23
4da19800b538b73d9300c810,"""Yvonne Gregory""",0,0,1,0,0,3,0,4
4da19803b538b73d9300c896,"""Bradley Greive""",2,0,2,2,0,1,0,7
4da1980ab538b73d9300c97b,"""Walter Burley Griffin""",0,0,6,6,0,5,3,20
4da1980cb538b73d9300c9d7,"""Elioth Gruner""",2,0,9,4,1,7,4,27
4da19817b538b73d9300cb0e,"""Nancy Guest""",3,0,3,9,1,1,3,20
4da1981cb538b73d9300cba0,"""Marjorie Gwynne""",7,0,6,4,0,6,3,26
4da19825b538b73d9300cd51,"""L. Bernard Hall""",0,0,27,7,0,3,0,37
4da19825b538b73d9300cd5c,"""Nancy Adrah Hall""",0,0,12,7,0,6,0,25
4da19825b538b73d9300cd64,"""Oswald Hall""",0,0,3,1,0,3,1,8
4da1984bb538b73d9300d224,"""Mary Packer Harris""",4,0,7,7,0,6,0,24
4da19864b538b73d9300d491,"""Weaver Hawkins""",14,0,4,10,0,7,13,48
4da19865b538b73d9300d4d5,"""Heliodore Hawthorne""",2,0,4,10,0,8,3,27
4da19866b538b73d9300d4f9,"""Elaine Alys Haxton""",26,0,20,17,2,15,6,86
4da1987ab538b73d9300d82c,"""Leonard Hessing""",2,0,4,1,0,1,0,8
4da19881b538b73d9300d841,"""Mona Hessing""",4,0,2,7,6,1,2,22
4da19886b538b73d9300d934,"""Hans Heysen""",4,0,15,12,0,8,2,41
4da19889b538b73d9300d98b,"""Jacqueline Hick""",11,0,9,8,4,14,4,50
4da19898b538b73d9300db61,"""Frank Hinder""",9,0,18,9,2,10,0,48
4da19898b538b73d9300db72,"""Margel Ina Hinder""",15,0,15,3,0,2,3,38
4da198a8b538b73d9300dd7c,"""Rayner Hoff""",0,0,26,2,0,2,0,30
4da198a8b538b73d9300dd7f,"""Pat Hoffie""",9,0,4,1,0,2,0,16
4da198b0b538b73d9300de1b,"""Edith Lilla Holmes""",9,0,11,9,1,9,0,39
4da198b6b538b73d9300df0a,"""Gordon Hookey""",11,0,14,3,8,12,9,57
4da198c2b538b73d9300e00f,"""Livingston Hopkins""",6,0,19,3,0,44,1,73
4da198c2b538b73d9300e03b,"""Roma Hopkinson""",3,0,5,5,0,6,1,20
4da198d3b538b73d9300e20e,"""Mollie Horseman""",3,0,32,11,2,43,0,91
4da198dbb538b73d9300e331,"""Ian Howard""",19,0,5,3,1,1,0,29
4da198e8b538b73d9300e4d1,"""Isabel Huntley""",3,0,8,10,0,4,0,25
4da198f3b538b73d9300e550,"""Ron Hurley""",29,0,12,4,15,6,19,85
4da19904b538b73d9300e844,"""Ysobel R. Irvine""",0,0,4,4,0,12,0,20
4da19915b538b73d9300ea4e,"""Dora Jarret""",11,0,9,5,0,15,0,40
4da19919b538b73d9300eac1,"""Margaret Jaye""",0,0,9,2,0,11,0,22
4da19926b538b73d9300eb44,"""Constance Lillian Jenkins""",6,0,10,6,3,10,0,35
4da19944b538b73d9300ef35,"""Kitty Kantilla""",1,0,2,1,0,1,0,5
4da19945b538b73d9300ef6e,"""Garry Jones""",3,0,3,8,3,1,3,21
4da19947b538b73d9300efb9,"""Jacob William Jones""",1,0,4,2,0,6,5,18
4da1994fb538b73d9300f073,"""Marion Jones""",8,0,7,8,1,13,7,44
4da19977b538b73d9300f439,"""Shirley Keene""",7,0,4,7,0,11,1,30
4da1997ab538b73d9300f493,"""Gladys Napangardi Kelly""",0,0,4,2,0,2,0,8
4da199bab538b73d9300f975,"""Amie Kingston""",13,0,12,14,1,14,2,56
4da199c5b538b73d9300fa51,"""Robert Klippel""",16,0,13,9,0,2,3,43
4da199d0b538b73d9300fabe,"""Emily Kame Kngwarreye""",27,0,9,2,1,7,11,57
4da199dab538b73d9300fb26,"""Lily Kngwarreye""",3,0,3,3,0,0,0,9
4da199f3b538b73d9300fd48,"""Lisette Anna Kohlhagen""",11,0,6,11,3,6,3,40
4da199f6b538b73d9300fdc5,"""William Lister Lister""",4,0,31,8,9,18,9,79
4da199fab538b73d9300ff1b,"""Annis Laeubli""",2,0,8,1,0,7,3,21
4da19a00b538b73d9300ff86,"""Jack Louis Koskie""",4,0,1,5,6,5,1,22
4da19a08b538b73d93010009,"""Hardtmuth Lahm""",3,0,2,2,0,13,0,20
4da19a0bb538b73d930100b1,"""Eirene Mort""",10,0,18,9,1,20,3,61
4da19a29b538b73d93010245,"""George Lambert""",5,0,36,8,2,20,0,71
4da19a34b538b73d93010385,"""Eleonore Henrietta Lange""",5,0,7,1,1,15,5,34
4da19a36b538b73d930103cb,"""Pat Larter""",2,0,11,11,0,2,2,28
4da19a43b538b73d9301041f,"""Loma Kyle Turnbull Lautour""",10,0,12,8,1,9,10,50
4da19a4fb538b73d93010612,"""Caroline Le Sou\u00ebf""",1,0,6,4,0,11,12,34
4da19a54b538b73d930106e2,"""Emma Timbery""",1,0,2,4,0,11,0,18
4da19a55b538b73d930106fa,"""Mitty Lee Brown""",3,0,11,10,1,8,1,34
4da19a66b538b73d930108e4,"""Helen Dora Lempriere""",11,0,10,8,0,13,3,45
4da19a83b538b73d93010c3c,"""Sara Levi""",10,0,15,5,1,18,0,49
4da19a84b538b73d93010c81,"""Margo Lewers""",21,0,11,3,0,10,2,47
4da19a87b538b73d93010cec,"""Aletta M. Lewis""",6,0,4,7,1,19,1,38
4da19aacb538b73d93010e5c,"""Bessie Liddle""",3,0,5,5,1,14,1,29
4da19ab1b538b73d93010f34,"""Daryl Lindsay""",0,0,34,2,1,4,0,41
4da19ab5b538b73d93010fbb,"""Norman Lindsay""",8,0,66,5,0,38,11,128
4da19ad9b538b73d930113ed,"""Mildred Esther Lovett""",8,0,16,8,0,14,1,47
4da19affb538b73d9301160f,"""Jennie Gorringe""",1,0,4,2,0,3,4,14
4da19b47b538b73d93011ac8,"""Jessie Mackintosh""",9,0,16,9,0,15,4,53
4da19b66b538b73d93011dbc,"""Frank Mahony""",8,0,21,6,0,24,7,66
4da19babb538b73d93012316,"""Mandy Martin""",15,0,8,7,0,8,0,38
4da19bd2b538b73d9301265d,"""Philip William May""",7,0,18,8,0,37,18,88
4da19be1b538b73d930128a6,"""Daphne Mayo""",9,0,13,13,5,4,10,54
4da19bf2b538b73d93012a31,"""Marjory Francesca McCrae""",1,0,13,3,0,18,0,35
4da19bf7b538b73d93012a82,"""David McDiarmid""",19,0,5,4,0,4,8,40
4da19c03b538b73d93012b95,"""Eileen McGrath""",0,0,8,6,1,8,1,24
4da19c0db538b73d93012c44,"""Phyllis McKillup""",0,0,3,4,1,2,0,10
4da19c10b538b73d93012cb3,"""Ethel Irene McLennan""",0,0,2,5,2,9,0,18
4da19c1fb538b73d93012dd5,"""Frank Charles Medworth""",2,0,11,3,0,11,3,30
4da19c29b538b73d93012e79,"""Dora Meeson Coates""",9,0,8,9,3,9,7,45
4da19c29b538b73d93012ed4,"""Max Meldrum""",2,0,30,17,1,6,6,62
4da19c2bb538b73d93012f29,"""Danie Mellor""",9,0,7,20,5,16,5,62
4da19c42b538b73d93013113,"""Bertha Elizabeth Merfield""",4,0,9,9,0,20,17,59
4da19c48b538b73d930131f8,"""Emily Meston""",7,0,7,2,0,23,7,46
4da19c4bb538b73d93013256,"""Margaret Michaelis-Sachs""",3,0,2,9,0,3,0,17
4da19c55b538b73d9301332c,"""Adelaide Miethke""",0,0,2,4,0,4,0,10
4da19c5cb538b73d930133d2,"""Olga Miller""",0,0,1,0,0,1,0,2
4da19caeb538b73d93013abd,"""Berthe Julie Lucie Mouchette""",6,0,7,7,1,17,3,41
4da19cb7b538b73d93013bf4,"""Arthur James Murch""",4,0,20,17,2,15,4,62
4da19cbab538b73d93013c61,"""Alec Murray""",0,0,11,6,0,4,0,21
4da19cc4b538b73d93013ce7,"""Alice Jane Muskett""",10,0,13,7,0,20,7,57
4da19cf6b538b73d93013f4f,"""Rupert Bunny""",4,0,23,10,0,11,8,56
4da19d24b538b73d930141ed,"""Rosaleen Norton""",3,0,9,3,0,6,4,25
4da19d43b538b73d93014479,"""Ann Foster Newmarch""",16,0,5,3,0,7,2,33
4da19d66b538b73d93014697,"""Lorna Nimmo""",11,0,8,8,3,4,1,35
4da19d85b538b73d93014889,"""T\u00e9cha Noble""",3,0,4,1,0,2,0,10
4da19d9fb538b73d93014a15,"""Alice Norton""",3,0,4,2,0,2,0,11
4da19db1b538b73d93014bc4,"""Barbary O'Brien""",6,0,11,2,0,11,0,30
4da19de8b538b73d93014e9e,"""Helen Elizabeth Ogilvie""",8,0,7,6,0,8,1,30
4da19deab538b73d93014ee9,"""Dora Ohlfsen-Bagge""",5,0,4,11,0,25,5,50
4da19e07b538b73d93014fb0,"""Margaret Olley""",24,0,17,18,1,3,2,65
4da19e22b538b73d93015140,"""Gladys Mary Owen""",19,0,9,12,1,17,1,59
4da19e39b538b73d93015202,"""Ethleen Mary Palmer""",15,0,9,2,0,4,2,32
4da19e6fb538b73d930154a6,"""Klytie Pate""",7,0,4,5,2,16,1,35
4da19e74b538b73d93015517,"""Eilean Pearcey""",0,0,3,4,1,1,0,9
4da19e78b538b73d93015573,"""Esther Paterson""",12,0,12,4,0,38,4,70
4da19e8ab538b73d93015658,"""Dorothy Ellsmore Paul""",3,0,12,5,0,9,1,30
4da19e8db538b73d9301567f,"""Emily Letitia Paul""",5,0,5,9,0,16,3,38
4da19e9cb538b73d93015702,"""Frances Payne""",6,0,11,10,2,14,5,48
4da19ec7b538b73d9301583f,"""Vicki Couzens""",5,0,21,4,2,7,2,41
4da19ecab538b73d930158b4,"""Janice Peacock""",11,0,14,8,3,5,6,47
4da19edcb538b73d93015a95,"""Marjory Penglase""",7,0,6,8,3,6,2,32
4da19edeb538b73d93015add,"""John Perceval""",8,0,13,11,1,5,2,40
4da19ef0b538b73d93015b74,"""Adelaide Perry""",23,0,20,10,1,14,3,71
4da19f20b538b73d93015d88,"""Violet Petyarre""",0,0,2,0,0,0,0,2
4da19f27b538b73d93015e55,"""Margaret Preston""",39,0,28,21,2,27,11,128
4da19f7cb538b73d9301617d,"""Lillian Pitts""",0,0,2,3,1,3,2,11
4da19fafb538b73d9301648f,"""Jane Price""",4,0,10,10,0,7,1,32
4da19fd3b538b73d9301654c,"""Thea Proctor""",37,0,47,12,0,23,9,128
4da1a014b538b73d93016817,"""Louis Pwerle""",1,0,3,2,0,1,0,7
4da1a024b538b73d930169a4,"""Wanda Radford""",0,0,9,0,0,1,0,10
4da1a094b538b73d93016d43,"""Geraldine Rede""",1,0,2,0,0,1,1,5
4da1a095b538b73d93016d75,"""Norma Redpath""",7,0,5,12,16,9,8,57
4da1a099b538b73d93016e14,"""Alison Rehfisch""",22,0,14,7,0,18,1,62
4da1a09fb538b73d93016f2c,"""Gladys Reynell""",5,0,4,13,0,10,2,34
4da1a0e2b538b73d93017120,"""Sue Richter""",9,0,5,0,0,3,0,17
4da1a0f5b538b73d930171d0,"""Louie Riggall""",7,0,6,14,3,12,0,42
4da1a120b538b73d930172c6,"""Dorothy Roberts""",1,0,3,0,1,1,0,6
4da1a122b538b73d9301731d,"""Hera Roberts""",2,0,6,5,0,13,4,30
4da1a123b538b73d9301735d,"""Neil Roberts""",7,0,2,2,0,3,2,16
4da1a12eb538b73d9301742d,"""Barbara Robertson""",2,0,1,1,0,2,1,7
4da1a141b538b73d930174fe,"""Toni Robertson""",16,0,4,1,0,5,4,30
4da1a144b538b73d93017553,"""Cheryl Moodai Robinson""",1,0,3,0,0,0,1,5
4da1a16ab538b73d93017776,"""Florence Aline Rodway""",14,0,15,7,4,11,8,59
4da1a1c4b538b73d93017bc9,"""Dattilo Rubbo""",0,0,31,7,1,4,0,43
4da1a1efb538b73d93017d52,"""Steven Russell""",3,0,11,4,2,2,3,25
4da1a1fab538b73d93017e28,"""Loudon Sainthill""",2,0,6,4,0,3,1,16
4da1a25ab538b73d930180e7,"""Theo Scharf""",4,0,1,6,0,11,3,25
4da1a2d9b538b73d93018860,"""Eliza Jeanette Sheldon""",2,0,6,7,0,1,0,16
4da1a3abb538b73d93018e32,"""Bertha Sloane""",0,0,6,2,0,4,0,12
4da1a3b8b538b73d93018f2f,"""Dorothy Ure Smith""",0,0,3,0,0,5,1,9
4da1a3bdb538b73d93018f9e,"""Grace Cossington Smith""",30,0,18,12,2,20,12,94
4da1a3bdb538b73d93018fc7,"""Gray Smith""",1,0,2,1,0,0,0,4
4da1a3cab538b73d930190e0,"""Sydney Ure Smith""",0,0,41,4,0,9,4,58
4da1a437b538b73d9301943e,"""Ethel Louise Spowers""",13,0,15,9,0,12,4,53
4da1a44bb538b73d930195b3,"""Ethel Stephens""",10,0,11,5,2,12,0,40
4da1a480b538b73d93019656,"""Helen Stewart""",1,0,4,13,0,2,0,20
4da1a48eb538b73d93019683,"""Janet Agnes Cumbrae Stewart""",18,0,11,12,3,11,3,58
4da1a53bb538b73d93019a89,"""David Strachan""",7,0,15,20,2,9,2,55
4da1a5d7b538b73d93019da8,"""Jane Sutherland""",3,0,13,7,1,15,4,43
4da1a5dab538b73d93019dcc,"""Jean Parker Sutherland""",6,0,8,11,1,7,2,35
4da1a5e9b538b73d93019f0c,"""Louisa J. Swan""",3,0,3,1,0,4,0,11
4da1a5eab538b73d93019f1a,"""Jo Sweatman""",6,0,7,2,0,4,1,20
4da1a5edb538b73d93019f6d,"""Dora Sweetapple""",2,0,21,8,0,7,0,38
4da1a676b538b73d9301a0c5,"""Eveline Winifred Syme""",15,0,12,8,0,17,3,55
4da1a679b538b73d9301a16c,"""Gordon Syron""",24,0,8,6,10,11,19,78
4da1a77fb538b73d9301a27b,"""Graham Fransella""",24,0,1,4,12,0,0,41
4da1a801b538b73d9301a643,"""Violet Teague""",9,0,13,12,3,17,12,66
4da1a81bb538b73d9301a8bb,"""Eric Thake""",18,0,9,5,2,21,4,59
4da1a885b538b73d9301acd5,"""Esme Timbery""",6,0,7,3,1,5,4,26
4da1a885b538b73d9301acf8,"""Rose Timbery""",1,0,4,2,1,1,0,9
4da1a905b538b73d9301ae6d,"""Roland Wakelin""",14,0,24,10,1,1,4,54
4da1a97cb538b73d9301b25b,"""John Robertson Tranthim-Fryer""",6,0,5,12,5,4,0,32
4da1a97fb538b73d9301b290,"""Peter Travis""",25,0,6,4,2,4,0,41
4da1a9aab538b73d9301b33c,"""Barbara Tribe""",8,0,4,9,2,16,4,43
4da1a9c9b538b73d9301b496,"""Marie Tuck""",9,0,12,8,1,12,6,48
4da1a9cab538b73d9301b4e0,"""Ruth Tuck""",9,0,7,6,6,10,1,39
4da1a9cab538b73d9301b508,"""Albert Tucker""",9,0,32,2,0,6,1,50
4da1a9ceb538b73d9301b57e,"""Peter Tully""",20,0,3,2,0,4,6,35
4da1aa3fb538b73d9301b7d7,"""May Vale""",3,0,13,11,0,10,0,37
4da1aa4cb538b73d9301b810,"""Vanessa Berry""",0,0,3,3,0,3,0,9
4da1aa8eb538b73d9301bbf2,"""Margaret Ellen Walker""",3,0,5,6,0,2,0,16
4da1aa90b538b73d9301bc15,"""Ngadijina Wilma Walker""",2,0,1,1,0,2,1,7
4da1ab44b538b73d9301bd2b,"""Edith Wall""",11,0,3,7,2,15,1,39
4da1ab49b538b73d9301be07,"""Christian Waller""",9,0,11,8,0,5,10,43
4da1ab4ab538b73d9301be36,"""Mervyn Napier Waller""",0,0,8,10,2,7,4,31
4da1ab7db538b73d9301bfd2,"""Frederick Ward""",0,0,4,0,0,0,0,4
4da1ac35b538b73d9301c305,"""Mary Webb""",2,0,4,4,0,0,0,10
4da1ac49b538b73d9301c438,"""Frank (Friedrich) Weitzel""",6,0,3,7,0,5,2,23
4da1ad3bb538b73d9301c87e,"""Janie Wilkinson Whyte""",0,0,8,3,0,2,1,14
4da1ad49b538b73d9301c91b,"""Anne Wienholt""",10,0,8,9,1,15,0,43
4da1adb1b538b73d9301cae0,"""Caroline Williams""",9,0,2,6,0,0,0,17
4da1aec9b538b73d9301d09f,"""Walter Withers""",4,0,26,15,1,5,1,52
4da1af08b538b73d9301d279,"""Arthur Thomas Woodward""",1,0,10,6,3,9,2,31
4da1af6fb538b73d9301d491,"""Verna Nichols""",6,0,4,9,3,2,9,33
4da1af76b538b73d9301d54e,"""Blamire Young""",2,0,15,23,0,21,1,62
4da1af8ab538b73d9301d5f2,"""Alleyne Clarice Zander""",1,0,15,5,0,16,0,37
4da1afa9b538b73d9301d824,"""Joshua Smith""",3,0,20,5,6,8,1,43
4da1afbcb538b73d9301d94d,"""Ivor Hele""",1,0,7,4,5,5,1,23
4da1afe7b538b73d9301dbb7,"""Kevin Atkinson""",3,0,3,3,0,1,3,13
4da1afe9b538b73d9301dbf1,"""Trisha Carroll""",9,0,7,7,2,1,2,28
4da1b023b538b73d9301dc9d,"""Daryl Austin""",33,0,21,9,6,0,0,69
4da1b0c0b538b73d9301dcfc,"""Virginia Cuppaidge""",21,0,8,6,4,0,0,39
4da1b201b538b73d9301e397,"""G. Gayfield Shaw""",2,0,25,9,1,6,0,43
4da1b28bb538b73d9301e4cf,"""Ambrose Patterson""",5,0,8,19,0,3,5,40
4da1b292b538b73d9301e5f5,"""Lloyd Rees""",25,0,21,6,0,10,7,69
4da1b296b538b73d9301e66c,"""Judy Watson""",39,0,17,11,11,13,15,106
4da1b299b538b73d9301e709,"""Charles Conder""",6,0,27,10,0,10,8,61
4da1b29bb538b73d9301e743,"""Caroline Barker""",7,0,20,9,4,4,4,48
4da1b2f1b538b73d9301e7f4,"""Sydney Long""",3,0,35,15,0,4,4,61
4da1b2f2b538b73d9301e81d,"""Norah Simpson""",2,0,4,9,0,4,0,19
4da1b2f6b538b73d9301e924,"""Mona Elliott""",2,0,3,5,0,7,1,18
4da1b2fab538b73d9301e9fd,"""Vernon Ah Kee""",15,0,15,5,2,5,9,51
4da1b4f4b538b73d9301ee81,"""Richard Larter""",22,0,14,9,3,5,8,61
4da1b4fab538b73d9301ef6b,"""Paula Dawson""",60,0,3,4,22,74,5,168
4da1b4fdb538b73d9301f0aa,"""Muriel Shaw""",6,0,16,20,0,11,3,56
4da1b4feb538b73d9301f0ce,"""George Bell""",0,0,15,12,0,4,10,41
4da1b509b538b73d9301f185,"""Robert Boynes""",21,0,5,6,5,3,4,44
4da1b5d0b538b73d9301f8b0,"""Dulcie Greeno""",5,0,10,2,0,1,0,18
4da1b5d4b538b73d9301f92d,"""Jeffrey Samuels""",18,0,6,9,4,3,3,43
4da1b5d5b538b73d9301f981,"""Muriel Maynard""",5,0,6,2,0,2,2,17
4da1b5d9b538b73d9301f9f1,"""Julie Gough""",26,0,5,11,14,13,10,79
4da1b5d9b538b73d9301fa7c,"""Judith-Rose Thomas""",4,0,1,4,2,1,0,12
4da1b5efb538b73d9301fb07,"""Shaun Gladwell""",19,0,13,5,4,3,32,76
4da1b5f8b538b73d9301fbeb,"""Janet Laurence""",27,0,2,3,10,1,40,83
4da1b640b538b73d9302000d,"""Lola Greeno""",9,0,14,7,1,5,7,43
4da1b641b538b73d9302004d,"""Julius Bokor""",1,0,10,5,0,1,0,17
4da1b6d1b538b73d9302058f,"""Andrea Fisher""",11,0,7,4,6,5,4,37
4da1b7acb538b73d93020a6a,"""Peter Tonkin""",1,0,8,5,9,1,7,31
4da1b7ddb538b73d93020b48,"""Esther Naomi Kirby""",6,0,3,5,3,5,3,25
4da1b7f5b538b73d93020e68,"""Mike Parr""",164,0,9,1,0,4,19,197
4da1b86eb538b73d930213cb,"""Ro Murray""",10,0,5,4,0,1,0,20
4da1b86fb538b73d930213f8,"""Tony Albert""",11,0,10,3,5,3,4,36
4da1b870b538b73d9302143f,"""Duncan Robinson""",11,0,4,5,0,6,2,28
4da1b874b538b73d930214a5,"""Jon Molvig""",36,0,18,9,7,3,16,89
4da1b87cb538b73d930215e5,"""Robert George Owen""",90,0,11,20,17,6,18,162
4da1b87db538b73d93021741,"""Michael Goldberg""",11,0,23,5,7,4,7,57
4da1b884b538b73d930217c1,"""Denise Robinson""",15,0,7,11,4,6,6,49
4da1b8e0b538b73d930219d6,"""Dale Jones-Evans""",21,0,4,6,32,0,8,71
4da1b94bb538b73d93021b2b,"""Tommy Watson""",11,0,1,3,1,2,3,21
4da1b963b538b73d93021ba0,"""Steve Sheridan""",6,0,2,3,1,2,1,15
4da1b980b538b73d93021d12,"""Hugh Ramsay""",38,0,22,9,14,44,163,290
4da1b980b538b73d93021d55,"""Joan Lindsay""",6,0,16,4,0,8,0,34
4da1ba7ab538b73d93022373,"""Betty Churcher""",10,0,9,15,3,1,1,39
4da1ba7cb538b73d930223c7,"""Maie Casey""",1,0,8,8,0,5,0,22
4da1ba8cb538b73d93022616,"""Lee Darroch""",10,0,8,3,5,1,13,40
4da1bb98b538b73d93022dce,"""Corrie Fullard""",12,0,9,8,5,3,2,39
4da1bbb1b538b73d93022e26,"""Sonja Hodge""",1,0,3,2,1,1,1,9
4da1bc05b538b73d93023068,"""Sidney Nolan""",51,0,10,14,1,24,13,113
4da1bc27b538b73d930232cc,"""Nici Cumpston""",14,0,10,11,4,16,3,58
4da1bc41b538b73d93023346,"""Leann Edwards""",4,0,1,7,2,4,3,21
4da1bc63b538b73d93023509,"""James Fraser Scott""",46,0,12,21,3,65,29,176
4da1bc65b538b73d930235d4,"""Fern Martins""",13,0,9,6,0,3,1,32
4da1bc66b538b73d9302361a,"""Gary Philip Lee""",6,0,1,6,2,16,5,36
4da1bc82b538b73d930236b2,"""Jeanette James""",7,0,4,2,2,2,2,19
4da1bcecb538b73d93023836,"""Robyne Latham""",9,0,2,9,6,2,2,30
4da1bd18b538b73d93023c4c,"""Michael Riley""",44,0,11,5,1,12,18,91
4da1bd20b538b73d93023da8,"""Vicki West""",23,0,11,5,1,3,2,45
4da1bd48b538b73d93023f39,"""Richard Bell""",24,0,15,2,5,6,9,61
4da1bd98b538b73d93024016,"""Jeffrey Smart""",9,0,7,15,1,3,22,57
4da1bd9fb538b73d9302414a,"""Charles Lloyd Jones""",3,0,12,5,2,11,0,33
4da1be5eb538b73d930242b8,"""Hal Missingham""",30,0,21,13,3,20,5,92
4da1be69b538b73d930244b9,"""Bindi Cole""",12,0,2,5,6,13,3,41
4da1be6db538b73d93024558,"""Rene Williamson""",4,0,2,5,0,1,0,12
4da1beebb538b73d930248b4,"""Bluey Roberts""",4,0,2,4,2,16,5,33
4da1beefb538b73d9302493e,"""Yhonnie Scarce""",19,0,6,10,13,14,5,67
4da1c1c2b538b73d93025021,"""Hilda Burston""",1,0,1,3,0,1,0,6
4da1c313b538b73d93025342,"""Karen Casey""",30,0,3,4,10,7,2,56
4da1c317b538b73d930253de,"""Francis Clinton Sherrin""",14,0,5,3,1,3,13,39
4da1c371b538b73d9302549b,"""Vivienne Binns""",33,0,8,4,5,5,23,78
4da1c4d3b538b73d930255c5,"""Joel Birnie""",5,0,1,5,3,5,2,21
4da1c4f8b538b73d930256a3,"""Yvonne Koolmatrie""",24,0,4,5,1,12,18,64
4da1c557b538b73d930257cf,"""Ellen Trevorrow""",16,0,2,2,0,10,1,31
4da1c66ab538b73d93025a2f,"""Penny Evans""",12,0,8,3,4,2,2,31
4da1c69bb538b73d93025aaa,"""Justin O'Brien""",5,0,11,4,1,9,5,35
4da1c6d4b538b73d93025c76,"""Mel O'Callaghan""",58,0,4,8,15,13,19,117
4da1c6feb538b73d93025ea2,"""Frances Belle Parker""",10,0,7,8,14,4,3,46
4da1c8f3b538b73d9302666d,"""Norma MacDonald""",13,0,3,10,5,9,6,46
4da1c921b538b73d93026929,"""Claire Healy""",6,0,7,3,12,5,12,45
4da1c92cb538b73d930269e1,"""Sean Cordeiro""",6,0,13,5,11,13,13,61
4da1ceb5b538b73d930276f6,"""Henri Bastin""",46,0,6,10,0,11,2,75
4da1d00db538b73d930279f9,"""Charles Meere""",4,0,1,4,2,12,8,31
4da1d060b538b73d93027b92,"""Linda Jackson""",95,0,10,15,5,37,76,238
4da1ddf5b538b73d93029049,"""Regina Walter""",58,0,1,3,0,23,1,86
4da1de91b538b73d93029638,"""Jack Carington Smith""",35,0,7,10,10,17,8,87
4da1de96b538b73d9302970c,"""Peter Elliston""",31,0,3,5,2,18,11,70
4da1e203b538b73d93029d94,"""Destiny Deacon""",17,0,8,2,0,35,3,65
4da1e57fb538b73d9302a270,"""Deborah Paauwe""",33,0,4,7,26,23,16,109
4da1e655b538b73d9302a3d9,"""Roger Foley""",2,0,7,4,0,3,2,18
4da1e680b538b73d9302a3f2,"""Deborah Ann Beck""",4,0,5,6,3,3,3,24
4da1eb4eb538b73d9302a7e0,"""Fiona Hall""",42,0,6,8,6,10,12,84
4da1eb5fb538b73d9302ab09,"""Sandy Edwards""",35,0,6,5,5,13,5,69
4da1ed90b538b73d9302af5d,"""Maria Cruz""",42,0,4,7,9,9,18,89
4da1febab538b73d9302c4b4,"""Kathleen Leichney""",3,0,9,4,0,2,0,18
4e13a32572edc27ef70000f3,"""Ross Rudesch Harley""",4,0,7,5,3,0,22,41
4e13e98a72edc27ef70001b8,"""David Haines""",5,0,4,2,0,1,2,14
4e13fe3372edc27ef7000236,"""George Khut""",6,0,7,6,2,4,6,31
4e1d85c372edc20ab3000171,"""Frederick McCubbin""",3,0,56,6,0,2,0,67
4e1ec9d972edc21f2f0001cd,"""Clement Meadmore""",6,0,12,6,3,22,11,60
4e1f926472edc24d91000154,"""James Gleeson""",10,0,7,5,0,0,3,25
4e1f927d72edc24d91000294,"""John Olsen""",16,0,36,34,0,4,3,93
4e1f927d72edc24d91000298,"""Desiderius Orban""",1,0,6,13,0,2,1,23
4e1f928072edc24d910002b9,"""Carl Plate""",5,0,4,0,0,0,1,10
4e1f928272edc24d910002de,"""Emanuel Raft""",6,0,7,9,0,1,1,24
4e1f928372edc24d910002e8,"""Stanislaus Rapotec""",2,0,1,1,0,7,1,12
4e1f928672edc24d91000315,"""Victor Rubin""",69,0,4,11,11,1,1,97
4e1f929072edc24d910003a1,"""Danila Vassilieff""",2,0,6,6,0,2,1,17
4e28ef68d707ff2c0f00003c,"""Emma Price""",0,0,3,0,0,0,0,3
4e47b2d3d707ff2f61000000,"""Jack Jans""",0,0,1,1,0,3,0,5
4e4f3c1ed707ff1f26000011,"""Tracey Moffat""",10,0,9,1,0,0,4,24
4e520273d707ff1dc70000f1,"""George Bell""",0,0,36,0,0,0,0,36
4e520284d707ff1dc700019f,"""Julian Ashton""",0,0,75,0,0,0,0,75
4e5202a9d707ff1dc7000302,"""Grahame King""",6,0,6,4,0,2,1,19
4e5202dad707ff1dc70004d4,"""Ken Watson""",1,0,3,0,0,0,0,4
4e520323d707ff1dc70007bd,"""John Passmore""",5,0,13,2,0,3,0,23
4e52035fd707ff1dc70009f0,"""A. Dattilo Rubbo""",0,0,12,0,0,0,0,12
4e5203c3d707ff1dc7000e30,"""Louis McCubbin""",0,0,6,0,0,0,0,6
4e5203c5d707ff1dc7000e3f,"""J. S. MacDonald""",0,0,3,0,0,0,0,3
4e5203c6d707ff1dc7000e44,"""Justus Jorgensen""",0,0,4,0,0,0,0,4
4e5203f3d707ff1dc700102d,"""Rah Fizelle""",6,0,11,0,0,0,0,17
4e520405d707ff1dc700110d,"""Muriel Burkitt""",1,0,3,2,0,0,0,6
4e52041ed707ff1dc7001239,"""Enid Cambridge""",10,0,5,3,0,2,0,20
4e520430d707ff1dc70012ec,"""Max Dupain""",0,0,11,0,0,0,0,11
4e52047fd707ff1dc700163d,"""Sidney Nolan""",0,0,9,0,0,0,0,9
4e5204a5d707ff1dc70017d7,"""Barbara Tribe""",4,0,3,0,0,0,0,7
4e52051ed707ff1dc7001d35,"""Michael Brown""",0,0,2,0,0,0,0,2
4e520550d707ff1dc7001f56,"""Leslie Wilkie""",0,0,7,0,0,0,0,7
4e520586d707ff1dc7002178,"""Godfrey Rivers""",0,0,13,0,0,0,0,13
4e5205f9d707ff1dc700261e,"""Bernard Smith""",0,0,13,0,0,0,0,13
4e520668d707ff1dc7002abf,"""John Howley""",1,0,2,2,0,0,0,5
4e52066ad707ff1dc7002ae3,"""Joan Grounds""",11,0,9,1,0,0,1,22
4e52066cd707ff1dc7002af0,"""Nigel Lendon""",0,0,2,0,0,0,0,2
4e52067fd707ff1dc7002ba8,"""Ace Bourke""",2,0,11,7,0,0,0,20
4e5206a8d707ff1dc7002d64,"""Kerry Dundas""",2,0,4,0,0,0,0,6
4e5206bed707ff1dc7002e27,"""Edgar Ritchard""",0,0,5,2,0,0,0,7
4e5206ded707ff1dc7002f1d,"""A. Henry Fullwood""",0,0,3,0,0,0,0,3
4e5206e1d707ff1dc7002f2b,"""Gertrude Williams""",1,0,1,0,0,0,0,2
4e5206f1d707ff1dc7002fc1,"""Dick Roughsey""",1,0,5,2,0,1,0,9
4e5206f6d707ff1dc7002ff3,"""Sam Atyeo""",1,0,12,8,0,2,0,23
4e520729d707ff1dc70031d0,"""Sweeney Reed""",1,0,3,0,0,0,0,4
4e520742d707ff1dc70032e2,"""Djon Mundine""",5,0,11,0,1,0,0,17
4e520744d707ff1dc70032f3,"""Greg Weight""",0,0,4,0,0,0,0,4
4e5207a1d707ff1dc70036b7,"""Kate O'Connor""",0,0,2,12,0,0,0,14
4e520860d707ff1dc7003e9e,"""Daniel Thomas""",7,0,10,1,0,0,0,18
4e520886d707ff1dc7004013,"""Leon Gellert""",0,0,4,0,0,1,0,5
4e520889d707ff1dc700402d,"""Fern Smith""",0,0,1,1,0,0,1,3
4e52089dd707ff1dc70040fd,"""Gerald Lewers""",1,0,4,0,0,0,0,5
4e520928d707ff1dc70045e9,"""Christopher Hodges""",0,0,5,0,0,0,0,5
4e520929d707ff1dc70045ef,"""Frank Watters""",1,0,16,2,0,3,0,22
4e520929d707ff1dc70045f3,"""Geoffrey Legge""",0,0,10,0,0,0,0,10
4e5209cad707ff1dc7004b87,"""Candice Bruce""",1,0,3,0,0,0,0,4
4e520a0bd707ff1dc7004df1,"""Adolph Gustav Plate""",1,0,4,2,0,0,0,7
4e520aa7d707ff1dc70052e0,"""W. B. McInnes""",0,0,5,0,0,0,0,5
4e520b7fd707ff1dc70059a5,"""John Chester Cato""",2,0,3,2,0,0,0,7
4e520b90d707ff1dc7005a37,"""Georges Mora""",0,0,3,0,0,0,0,3
4e520b92d707ff1dc7005a3b,"""William Mora""",0,0,1,0,0,0,0,1
4e520b93d707ff1dc7005a3e,"""Philip Mora""",0,0,1,0,0,0,0,1
4e520bc9d707ff1dc7005bee,"""Lesley Walford""",0,0,3,2,0,2,0,7
4e520bcbd707ff1dc7005bfa,"""Jocelyn Rickards""",0,0,4,1,0,0,0,5
4e520be3d707ff1dc7005ce6,"""Sam Schoenbaum""",11,0,11,1,0,1,2,26
4e520c72d707ff1dc700616e,"""David Rose""",3,0,1,0,0,0,0,4
4e520ccdd707ff1dc70063ef,"""Brenda L. Croft""",0,0,10,0,0,0,0,10
4e520d42d707ff1dc700675a,"""W. Lister Lister""",0,0,2,0,0,0,0,2
4e520d43d707ff1dc7006761,"""Edith Collier""",0,0,2,0,0,0,0,2
4e520d44d707ff1dc700676b,"""Ina Gregory""",0,0,2,0,0,0,0,2
4e520d51d707ff1dc70067d3,"""Ailsa Lee Brown""",0,0,1,0,0,0,0,1
4e520dddd707ff1dc7006bd4,"""Joanna Mendelssohn""",5,0,14,13,1,0,0,33
4e5210d6d707ff1dc700834a,"""Andrew J. Sibley""",3,0,3,8,0,0,1,15
4e521153d707ff1dc700869e,"""Blair French""",0,0,2,0,0,0,0,2
4e521173d707ff1dc7008715,"""Glenda King""",2,0,2,0,0,0,0,4
4e521188d707ff1dc700876e,"""Hetti Perkins""",3,0,5,0,0,0,0,8
4e5211d5d707ff1dc7008908,"""Roy Churcher""",1,0,5,0,0,0,0,6
4e5211efd707ff1dc7008982,"""Lena Nyadbi""",1,0,1,2,0,0,0,4
4e5211f1d707ff1dc700898b,"""Gulumbu Yunupingu""",1,0,1,2,0,0,0,4
4e52120fd707ff1dc7008a09,"""Ivan McMeekin""",3,0,10,2,1,10,0,26
4e521236d707ff1dc7008aa4,"""Peter Leslie Pinson""",2,0,16,7,1,0,0,26
4e521287d707ff1dc7008bd7,"""Antonio Dattilo Rubbo""",0,0,6,3,0,0,0,9
4e521323d707ff1dc7008e99,"""Valerie MacSween""",1,0,3,2,0,0,0,6
4e521424d707ff1dc7009293,"""Merryn Gates""",6,0,1,0,0,0,0,7
4e52144ad707ff1dc7009327,"""Paul Cox""",0,0,4,0,0,0,0,4
4e521459d707ff1dc7009365,"""Nell""",1,0,1,4,0,0,0,6
4e52145cd707ff1dc7009374,"""Jonathan Baskett""",1,0,2,1,0,1,0,5
4e521481d707ff1dc700941d,"""Bill Wright""",1,0,1,0,0,0,0,2
4e52158dd707ff1dc7009821,"""Virginia Fraser""",0,0,2,0,0,0,2,4
4e5215fbd707ff1dc7009a41,"""John Firth-Smith""",10,0,5,1,0,0,0,16
4e521601d707ff1dc7009a65,"""Nick Waterlow""",5,0,6,2,0,4,0,17
4e521665d707ff1dc7009c44,"""Sydney Ball""",1,0,6,13,1,2,0,23
4e55ec40d707ff466a000003,"""Michael Callaghan""",2,0,8,4,0,19,15,48
4e5db9ecd707ff699b000018,"""Garry Emery""",0,0,1,0,0,0,0,1
4e5dba81d707ff699b00001a,"""Marian Hosking""",2,0,1,1,0,1,0,5
4e5dbaa7d707ff699b00001c,"""Harry Rowlands""",0,0,1,0,0,0,0,1
4e5dca26d707ff6983000020,"""Leo Brereton""",0,0,2,0,0,0,0,2
4e5f146dd707ff777d000030,"""Peter Rushforth""",5,0,22,10,2,7,2,48
4e686432d707ff67ba00000e,"""Ivan Englund""",5,0,3,5,0,4,4,21
4e700097d707ff523a000004,"""Grant Featherston""",3,0,7,2,0,10,8,30
4e71593dd707ff1637000009,"""Marea Gazzard""",9,0,7,3,0,7,5,31
4e716a90d707ff128600000f,"""Bruce Goold""",1,0,2,1,0,1,1,6
4e82c91ad707ff24ae00002d,"""Rei Kawakubo""",0,0,1,0,0,1,1,3
4e82c94fd707ff7424000032,"""Yohji Yamamoto""",0,0,1,0,0,1,1,3
4e82c9a0d707ff7424000034,"""Rolley Clark""",0,0,1,0,0,1,1,3
4e82cc4bd707ff41b200001b,"""Susie Middleton""",0,0,1,0,0,0,0,1
4e82cf7dd707ff41b2000020,"""Anne Jones""",0,0,1,0,0,1,1,3
4e82d2d6d707ff742400003c,"""Masahiro Nakagawa""",0,0,1,0,0,1,1,3
4e8e60b9d707ff4470000002,"""Banduk Marika""",7,0,3,2,0,1,1,14
4e9649f0d707ff26da000023,"""Max Hutchinson""",0,0,16,0,0,5,0,21
4e978eb7d707ff2d27000008,"""Aleks Danko""",28,0,16,2,1,2,3,52
4eb319f6d707ff4ebc000000,"""Helen S. Tiernan""",18,0,12,13,4,5,23,75
4ed4699dd707ff4ff0000000,"""Sydney Ball""",13,0,2,4,0,3,0,22
4ed4706ed707ff4fef000002,"""Peter Booth""",13,0,2,5,1,1,0,22
4ed47410d707ff544e000001,"""Gunter Christmann""",22,0,2,5,0,3,0,32
4edb623dd707ff4f7f000004,"""Daniel Thomas""",2,0,19,10,0,3,0,34
4edb690fd707ff4d07000007,"""Jennifer Phipps""",2,0,7,2,0,0,0,11
4edc8d84d707ff7ecd000004,"""Joan Kerr""",14,0,17,8,0,4,0,43
4edeb251d707ff7830000e4b,"""Annie Georgeson""",0,0,2,0,0,16,14,32
4edeb31ad707ff78300011b4,"""Jenny Kee""",5,0,19,4,0,72,72,172
4edeb33fd707ff7830001243,"""Jan Ayres""",0,0,1,0,0,1,1,3
4edeb360d707ff78300012cf,"""Una Barlowe""",0,0,1,0,0,1,1,3
4edeb370d707ff7830001317,"""Paula Martin""",0,0,1,0,0,2,2,5
4edeb370d707ff783000131a,"""Greg Somerville""",0,0,1,0,0,3,3,7
4edeb3c8d707ff7830001488,"""Karl Lagerfeld""",0,0,1,0,0,1,1,3
4edeb455d707ff783000174b,"""Marie McMahon""",10,0,4,1,0,9,10,34
4edeb632d707ff7830001ed1,"""Gloria Temarre Petyarre""",1,0,1,0,0,1,1,4
4edf1528d707ff4247000000,"""Frances Burke""",4,0,17,6,2,7,166,202
4ee49f66d707ff75d1000005,"""Margaret Worth""",5,0,5,7,0,2,0,19
4f024c92d707ff71f9000000,"""Godfrey Miller""",2,0,14,21,0,4,0,41
4f07c93cd707ff33c3000003,"""Eleanor Harding""",0,0,1,0,0,0,0,1
4f07c9e5d707ff328b000002,"""Hetti Perkins""",0,0,1,0,0,0,0,1
4fdeaf5cd707ff2e11000025,"""Jack Giles""",0,0,1,0,0,0,0,1
4fdeafb1d707ff2df900001c,"""Liz Blaxland""",1,0,1,0,0,0,0,2
4fded562d707ff2df9000025,"""Patricia Cardoso""",0,0,1,0,0,0,0,1
4ff17be9d707ff6aa200001f,"""Brian Medlin""",1,0,2,0,0,1,0,4
4ff7b5bdd707ff0d4300005a,"""Roger Noakes""",4,0,4,8,1,1,1,19
4ffc16a7d707ff1810000019,"""Dawn Fitzpatrick""",3,0,6,5,0,2,0,16
5023a3d7d707ff5ec3000009,"""Renee Free""",1,0,4,0,0,0,0,5
5062402dd707ff0bcc000029,"""Schulim Krimper""",0,0,6,0,0,6,0,12
50800b94d707ff342c000065,"""Carol Jerrems""",8,0,2,1,0,0,3,14
50b81bc8d707ff3126000002,"""Mabel Juli""",10,0,6,1,3,4,1,25
50b826cad707ff7732000007,"""Queenie McKenzie""",2,0,1,4,0,0,0,7
50b82789d707ff773200000a,"""Madigan Thomas""",0,0,1,0,0,0,0,1
50b83ea4d707ff7732000015,"""Freddie Timms""",5,0,5,1,0,2,3,16
50b84209d707ff6276000003,"""Rusty Peters""",1,0,2,3,0,0,1,7
50be07b4d707ff7cba000091,"""Jean Baptiste Apuatimi""",1,0,2,0,0,1,0,4
50be36c4d707ff0be0000002,"""Declan Apuatimi""",0,0,1,0,0,0,0,1
513fd529d707ff6bcd0017bf,"""Lyndon Dadswell""",1,0,3,0,0,0,0,4
513fd62dd707ff6bcd00185e,"""Helen Eager""",13,0,3,0,0,0,0,16
513fd693d707ff6bcd001899,"""Deej Fabyc""",3,0,6,8,0,0,1,18
513fdb7fd707ff6bcd001b82,"""Helge Larsen""",3,0,1,0,0,0,0,4
513fdcbdd707ff6bcd001c1d,"""Jan Mackay""",3,0,3,1,0,0,0,7
513fe6e9d707ff6bcd002190,"""Geoff Wilson""",6,0,1,0,0,0,0,7
51425dfbd707ff13a2000059,"""Mishka Buhler""",2,0,4,4,0,2,1,13
51425e58d707ff13a20000c3,"""Ralph Eberlein""",5,0,2,4,1,5,1,18
514e64a6d707ff2ede001ad9,"""Marr Grounds""",6,0,2,0,0,1,5,14
514e6f84d707ff2ede002580,"""Sherre DeLys""",0,0,1,1,0,1,1,4
514e704ad707ff2ede002624,"""Victoria Lynn""",15,0,1,0,0,1,0,17
514e70f3d707ff2ede0026aa,"""Elvis Richardson""",5,0,3,0,1,2,11,22
51886b94d707ff39f2000008,"""Joe  Croft""",0,0,1,0,0,1,0,2
51afe755d707ff3a35000002,"""Clare Milledge""",9,0,5,3,0,0,0,17
52829c1dd707ff54e5000000,"""Eric Maguire""",0,0,3,2,0,2,0,7
529932c8d707ff35f8000004,"""Donald Gazzard""",0,0,1,2,0,0,0,3
52993310d707ff3435000002,"""Jane Burns""",0,0,2,0,0,2,0,4
53eb18dcd707ff0c3e000002,"""Amala Groom""",18,0,5,4,2,2,0,31
5429fc22d707ff2d0e00002f,"""Kate Daw""",2,0,4,3,1,2,0,12
542b816fd707ff0c420000a7,"""Christina Davidson""",1,0,1,0,0,1,0,3
54348b82d707ff30a900001b,"""Luke Pellatt""",1,0,12,2,0,1,0,16
543da0cdd707ff7306000008,"""May Grigg""",2,0,2,0,0,0,0,4
54582b22d707ff605b000040,"""Christine Anu""",1,0,1,0,0,0,0,2
545c8cced707ff48d5000000,"""William Wright""",1,0,1,9,0,0,0,11
5466ceb2d707ff0d77000004,"""Shirley Purdie""",4,0,3,1,1,0,0,9
5466ddd7d707ff0d74000006,"""Kathy Ramsey""",2,0,3,0,0,0,0,5
54d5626ad707ff7335000000,"""Jeannie Herbert Punayi Nungarrayi""",0,0,1,0,0,3,0,4
556cddd9d707ff4ba5000004,"""Nell  Campbell""",0,0,2,0,0,0,0,2
556fd434d707ff2d42000030,"""Sarah de Teliga""",1,0,3,0,0,0,0,4
5576988dd707ff6a51000000,"""Anna Plunkett""",0,0,3,1,0,0,0,4
55769900d707ff6a51000002,"""Luke Sales""",0,0,3,1,0,0,0,4
55efaaead707ff1039000000,"""Barrupu Yunupingu""",2,0,1,1,0,0,0,4
55efdafcd707ff103900001a,"""Ruby  Djikarra Alderton""",1,0,1,0,0,0,0,2
55efdbfad707ff103900001f,"""Galuma Maymuru""",26,0,14,5,0,10,0,55
561dcad0d707ff0fde000005,"""Ian Hobbs""",0,0,3,0,0,0,0,3
564947c7d707ff73e200000d,"""Max Collard""",0,0,2,2,0,0,0,4
5743cb2fd707ff4f4d000016,"""Simon Barney""",0,0,2,0,0,0,0,2
5743cb82d707ff4f41000019,"""Chandler Coventry""",0,0,1,0,0,0,0,1
58f84070d707ff103f00000a,"""Olga Sharp""",0,0,1,0,0,0,0,1
5a0e6378d707ff0f93000024,"""Susan Marawarr""",21,0,20,3,0,5,0,49
5a62a9c5d707ff4df8000036,"""Noel Flood""",21,0,32,15,2,8,0,78
5b5e56acd707ff0f8a000011,"""Saville Whiting""",0,0,1,1,0,0,0,2
5d1054c0ede610348c000021,"""Shane  Forrest""",0,0,1,0,0,0,0,1
5d1054f8ede610348c000024,"""Jane  Naylor""",0,0,1,0,0,0,0,1
5d106055ede610348c000039,"""Terry Reid""",0,0,1,0,0,0,0,1
5d367375ede610348c000270,"""Dymphna Kerinauia""",1,0,1,1,0,0,0,3
5d42440bede610348c0004c5,"""Mitch Cairns""",1,0,1,0,0,0,0,2
5d5686efede610348c0006ad,"""Mary Callaghan""",0,0,2,0,0,2,0,4
5f75d237d707ff16ba00000b,"""Elizabeth Ann Macgregor""",0,0,1,0,0,0,0,1
5f7670b4d707ff16ba000020,"""Rob Scott-Mitchell""",0,0,1,0,0,0,0,1
601b3c97d707ff2e60000039,"""Louise  Owen""",19,0,2,6,4,0,6,37
60f7a81bd707ff05e30000b5,"""Alexander  Boynes""",0,0,1,0,0,0,0,1
